Voici une explication de chaque package dans votre fichier package.json. Les packages sont class√©s en fonction de leur r√¥le dans votre projet.

1. D√©pendances principales (dependencies)
Ces packages sont n√©cessaires pour ex√©cuter votre application en production.

Package	Description
@auth0/auth0-react	Permet d'int√©grer l'authentification avec Auth0 dans une application React.
@fullcalendar/...	Ensemble de composants pour afficher des calendriers interactifs.
@mobiscroll/react-lite	Biblioth√®que d'UI pour cr√©er des interfaces modernes et r√©actives (calendriers, s√©lecteurs, etc.).
@react-google-maps/api	Fournit une API pour int√©grer Google Maps dans React.
@reactour/tour	Utilis√© pour cr√©er des visites guid√©es interactives de votre application.
ajv et ajv-keywords	Valident les donn√©es JSON par rapport √† un sch√©ma JSON, souvent utilis√© pour la validation d'entr√©e.
apexcharts et react-apexcharts	Biblioth√®que de graphiques pour cr√©er des visualisations interactives.
axios	Client HTTP pour effectuer des requ√™tes (GET, POST, etc.) vers des APIs.
body-scroll-lock	Verrouille le d√©filement de l'arri√®re-plan lorsqu'un √©l√©ment comme une modale est actif.
bootstrap-scss	Version SCSS de Bootstrap, un framework CSS populaire.
chart.js et react-chartjs-2	Pour cr√©er des graphiques interactifs. Chart.js est la biblioth√®que principale, react-chartjs-2 l'int√®gre √† React.
chartjs-plugin-datalabels	Ajoute des √©tiquettes de donn√©es sur les graphiques cr√©√©s avec Chart.js.
date-fns	Fournit des utilitaires pour manipuler et formater les dates.
deni-react-treeview	Cr√©e des arbres de navigation interactifs (tree views) dans React.
easymde et react-simplemde-editor	√âditeur de texte Markdown simple et l√©ger.
emoji-mart	Permet d'int√©grer un s√©lecteur d'√©mojis dans votre application.
feather-icons	Biblioth√®que d'ic√¥nes vectorielles l√©g√®res et simples.
i18next, i18next-browser-languagedetector, i18next-http-backend, react-i18next	Fournissent une solution compl√®te pour l'internationalisation (i18n) dans React.
json-server	Cr√©e rapidement une API REST simul√©e pour tester votre frontend.
knob	Permet de cr√©er des √©l√©ments interactifs de type bouton rotatif.
leaflet et react-leaflet	Biblioth√®que de cartographie pour afficher des cartes interactives. react-leaflet l'int√®gre dans React.
pigeon-maps	Biblioth√®que alternative pour afficher des cartes dans React.
react-18-image-lightbox	Affiche des galeries d'images avec un effet de lightbox.
react-ace	√âditeur de code bas√© sur Ace Editor, int√©gr√© √† React.
react-big-calendar	Cr√©e des calendriers interactifs pour afficher des √©v√©nements.
react-bootstrap et react-bootstrap-typeahead	Fournissent des composants Bootstrap natifs pour React, y compris un typeahead (suggestion automatique).
react-clock	Affiche des horloges analogiques ou num√©riques dans React.
react-copy-to-clipboard	Permet de copier du texte dans le presse-papiers.
react-countdown	Chronom√®tre √† rebours int√©gr√© dans React.
react-countup	Anime les valeurs num√©riques croissantes ou d√©croissantes.
react-custom-scrollbars-2	Fournit des barres de d√©filement personnalis√©es.
react-data-table-component	Cr√©e des tableaux de donn√©es interactifs dans React.
react-datepicker	Composant React pour la s√©lection de dates.
react-day-picker	Biblioth√®que de s√©lection de dates avec des fonctionnalit√©s avanc√©es.
react-dnd et react-dnd-html5-backend	Fournissent des fonctionnalit√©s de glisser-d√©poser (drag-and-drop) dans React.
react-dragula	Une autre biblioth√®que pour impl√©menter le drag-and-drop.
react-dropzone-uploader	Permet de t√©l√©charger des fichiers avec une interface utilisateur conviviale.
react-feather	Fournit des ic√¥nes Feather adapt√©es √† React.
react-files	G√®re la s√©lection de fichiers dans React.
react-google-charts	Int√®gre les Google Charts dans React.
react-gradient-timepicker	S√©lecteur d'heure avec d√©grad√© visuel.
react-hook-form	Fournit des fonctionnalit√©s avanc√©es pour la gestion des formulaires dans React.
react-icons	Regroupe des biblioth√®ques d'ic√¥nes pour React, comme FontAwesome, Material Icons, etc.
react-image-crop	Permet de recadrer des images dans React.
react-masonry-css	G√®re des grilles de type ma√ßonnerie (Masonry layout).
react-perfect-scrollbar	Fournit des barres de d√©filement fluides et personnalis√©es.
react-range	Cr√©e des curseurs (sliders) interactifs.
react-rating et react-ratings-declarative	Permettent d'afficher des syst√®mes de notation avec des √©toiles ou d'autres formes.
react-redux	Fournit l'int√©gration de Redux avec React pour g√©rer l'√©tat global de l'application.
react-router et react-router-dom	Biblioth√®que pour g√©rer la navigation (routes) dans React.
react-scripts	Configuration et scripts utilis√©s par Create React App.
react-select	Composant pour cr√©er des menus d√©roulants stylis√©s.
react-slick et slick-carousel	Cr√©e des carrousels ou des sliders d'images ou de contenu.
react-sparklines	Affiche des graphiques de type "sparkline" (petits graphiques lin√©aires).
react-to-print	Fournit une fonctionnalit√© d'impression pour React.
react-toastify	Affiche des notifications toast (petits messages d'information).
react-transition-group	Permet de g√©rer les animations de transition dans React.
react-use-file-upload	Simplifie l'upload de fichiers.
react-uuid	G√©n√®re des UUID uniques dans React.
react-vertical-timeline-component	Affiche des lignes du temps verticales.
reactstrap	Fournit des composants Bootstrap adapt√©s √† React.
redux et redux-saga	Gestion avanc√©e de l'√©tat global et des effets secondaires.
sass	Compile le SCSS en CSS.
styled-components	Permet de styliser les composants React avec CSS-in-JS.
sweetalert2	Affiche des alertes styl√©es.
web-vitals	Mesure les performances de l'application.
world-map-geojson	Fournit des donn√©es g√©ographiques pour les cartes mondiales.
2. D√©pendances de d√©veloppement (devDependencies)
Ces packages sont n√©cessaires uniquement pour le d√©veloppement.

Package	Description
@babel/plugin-proposal-private-property-in-object	Plugin Babel pour prendre en charge les propri√©t√©s priv√©es des objets.
moment et moment-timezone	G√®rent les dates et fuseaux horaires.
react et react-dom	Les biblioth√®ques principales pour cr√©er des interfaces React.
Si vous avez besoin d'explications plus d√©taill√©es ou d'exemples pour un package particulier, n'h√©sitez pas ! üòä




